MMMMMMMMMMMMMMMMMMMMMMMMMMMMMMMM
MTTTTTDTTTTTRTTTTTTTTTTTTTTTTTTM
MPTTTRTTTTTDDDTTTTTTTTTTTTTTTTTM
MTTTTRTTTTTTTTTTTTTTTTTTTTTTTTTM
MTTTTTTTRRTTTTTTTTTTRTTTTTTTTTTM
MTTTTTTTTTTTTTTTTTTTTTTTTTTTTTTM
MTTTTTTTTTTTTTTTTTRTTTTTTTTTTTTM
MTTTTTTTTTTTTTTTTTTTTTTTTTTTTTTM
MTTTTTTTTTRTTTTTTTTTTTTTTTRRTTTM
MTTTTTTTTTTTTTTTTTTTTTTTTTTTTTTM
MTTTTTTTRTTTTTTTTTTTTTTTTTRTTTTM
MTTTTTTTTTTTTTTTTTTTTTTTTTRTTTTM
MTTTTRTTTTTTTTTTTTTTTTTTTTTTTTTM
MTTTTTTTTTTTTTTTTTRTTTTTTTTTTTTM
MTTTTTTTTTTTTTTTTTTTTTTTTTRTTTTM
MMMMMMMMMMMMMMMMMMMMMMMMMMMMMMMM