MMMMMMMMMMMMMMMMMMMMMMMMMMMMMMMM
MPTTTTDTTRTTTRTTTTTTTTTTTTTTTTTM
MTTTTRTTRTDDDTTTTTRRRTTRTTTTTTRM
MTTTTRTTTTTTRTTTTTTTTTTTTTTTTTTM
MTTTTTTTRRTTTRTTTTTTRTTTTTTTTTTM
MTTTTTTTRTTTTTTTTTTTTTRRTTTTTTTM
MTTTTTTTRTTTTTTTTTRTTTTTTTTTRRTM
MTTTTTTTTTTTTTRTTTTRTTTTRTTTTTTM
MTTTRTTTTTRTTTDTTTTTTTTTTRRTTRTM
MTTTTTTTTTTTRTTTTTRRRTTTTTTTTTTM
MTTTRTTTRTTTTTTTTTTTTTTTTTRTTTTM
MTTTTTTTTTTTTRRRTTTTTTTTTTRTTTTM
MTTTTRTTRTTTTTTTTTTTTTTTTTTTTTTM
MTTTTTTTTTTTDTTTTTRTTTTTTTTTTTTM
MTTTTTTTTTTTTTTTTTTTTTTTTTRTTTTM
MMMMMMMMMMMMMMMMMMMMMMMMMMMMMMMM