MMMMMMMMMMMMMMMMMMMMMMMMMMMMMMMM
MPTTTTDTTRTTTRTTTTRRTTTTTTTTTTTM
MTTTTRTTRTDDDTTTTTRRRTTRTTTTTTRM
MTTTTRTTTTTTRTTTTRRTTTTTTTTTTTTM
MTTTTTTTRRTTTRTTTTTTRTTTTTTTTTTM
MTRRTTTTRTTTTRRRRTTTTTRRTTTTTTTM
MTTTTTTTRTTTTTTTTTRTTTTTTTTTRRTM
MTTTRTTRRRRRTTRTTTTRTTTTRTTTTTTM
MTTTRTTTTTRTTTTTTTTTTTTTTRRTTRTM
MTTTTTTTTTTTRTTTTTRRRTTTTTTTTTTM
MTTTRTTTRTTTTTTTTTTTTTTTTTRTTTTM
MTTTTTTTTTTTTRRRTTTTTTTTTTRTTTTM
MTTTTRTTRTTTTTTTRRRRRTTTTTTTTTTM
MTTTTTTTTTTTTTTTTTRTTTTTTTTTTTTM
MTTTTTRRRRRRTRRRRRRRRRRRRTRTTTTM
MMMMMMMMMMMMMMMMMMMMMMMMMMMMMMMM