MMMMMMMMMMMMMMMMMMMMMMMMMMMMMMMM
MPTTTTDTTRTTTRTTTTRRTTTTTTTTTTTM
MTTTTRTTRTDDDTTTTTRRRTTRTTTTTTRM
MTMMMMMMMMMMMMRTTTTRRTTTTTTTTTTM
MTTTTTTTRRTTTRTTTTTTRTTTTTTTTTTM
MTRRTMMMMMMMMMMMMRRRTTTTTRRTTTTM
MTTTTTTTRTTTTTTTTTRTTTTTTTTTRRTM
MTTTRTTRRRRRTTRTTTMMMMMMMMMMMTTM
MTTTRTTTTTRTTTTTTTTTTTTTTRRTTRTM
MTTTTTTTTTTTRTTTTTRRRTTTTTTTTTTM
MTTTRTTTRTTTTTTTTMMMMMMMMMMMMTTM
MTTTTTMMMMMMTRRRTTTTDTTTTTRTTTTM
MTTTTRTTRTTTTDTTRRRRRTTTTTTTTTTM
MTTTDTTTTTDTTTTTTTRTTTMMMMMTTTTM
MTTTTTRRRRRRTRRRRRRRRRRRRTRTTTTM
MMMMMMMMMMMMMMMMMMMMMMMMMMMMMMMM